NO textures/NO_brick_wall.xpm
SO textures/SO_brick_wall.xpm
WE textures/WE_brick_wall.xpm
EA textures/EA_brick_wall.xpm

F 96,96,96
C 51,153,255
                                     111
        1111111111111111111111111    101
        1000000000100000000000001    101
        1010000000100000000000001    111
        1001000000000000000S00001  
111111111010000001110000000000001 1111
100000000000000011110111111111111 1001
11110111111111011100000010001     1111
11110111111111011101010010001
11000000110101011100000000001
10000000000000001100000010001
10000000000000001101010010001
11000001010101011111011110001
1111011101110101 101111010001
1111111111111111 111111111111