NO textures/NO_brick_wall.xpm
SO textures/SO_brick_wall.xpm
WE textures/WE_brick_wall.xpm
EA textures/EA_brick_wall.xpm

F 96,96,96
C 51,153,255

11111111111111111111111111111111
11111111111111111111111111111111
11111111111100000000011111111111
11111111111010000000101111111111
111111111101000N0000101111111111
11111111110000000000000111111111
11111111110000000000000111111111
11111111110000000000000111111111
11111111110100000000001011111111
11111111111010000000101111111111
11111111111100000000011111111111
11111111111111111111111111111111
11111111111111111111111111111111