NO textures/NO_brick_wall.xpm
SO textures/NO_brick_wall.xpm
WE textures/NO_brick_wall.xpm
EA textures/NO_brick_wall.xpm

F 96,96,96
C 51,153,255

        1111111111111111111111111
        1000000000100000000000001
        101000000100000000000001
        1001000000000000100000001
111111111010000001110000000000001
1000S00000DD000001110111111111111
1111D111111111011100000010001
11110111111111011101010010001
11000000110101011100000000001
10000000000000001100000010001
10000000000000001101010010001
11000001010101011111011110001
1111011101110101 101111010001
1111111111111111 111111111111