NO textures/NO_brick_wall.xpm
SO textures/SO_brick_wall.xpm
WE textures/WE_brick_wall.xpm
EA textures/EA_brick_wall.xpm

F 96,96,96
C 51,153,255

111111111111111111111111111111111
111111111000000000100000000000001
111111111011000001010000000000001
111111111001000000000000000000001
101111111011000001110000000000001
1000000000110000011101111111111N1
11110111111111011100000010001
11110111111111011101010010001
11000000110101011100000000001    
10000000000000001100000010001
10000000000000001101010010001
11000001110101011111011110001
11110111 1110101 101111010001
11111111 1111111 111111111111