WE textures/porte_close.xpm
NO textures/diamand.xpm
NO textures/diamand.xpm
SO textures/locharve.xpm
EA textures/rune.xpm
EA textures/rune.xpm
C 51,153,255
F 96,96,96


        1111111111111111111111111
        1000000000100000000000001
        1011000000100000000000001
        1001000000000000100000001
111111111010000001110000000000001
1000S00000DD000001110111111111111
1111D111111111011100000010001
1111011111111101 101010010001
11000000110101011100000000001
1D000000000000001100000010001
10000000000000001101010010001
11000001010101011111011110001
1111011101110101 101111010001
1111111111111111 111111111111 0