111111111111111111111111111111111
122222221000000000110000000000001
122222221011000001110000000000001
12222222100100000000W000000000001
131111111011000001110000000000001
100000000011000001110111111111111
11110111111111011100000010001
11110111111111011101010010001
11000000110101011100000000001
10000000000000001100000010001
10000000000000001101010010001
11000001110101011111011110001
11110111 1110101 101111010001
11111111 1111111 111111111111