NO textures/NO_brick_wall.xpm
SO textures/SO_brick_wall.xpm
WE textures/WE_brick_wall.xpm
EA textures/EA_brick_wall.xpm
DO textures/doortile.xpm
F 96,96,96
F 96,96,96
        1111111111111111111111111
        1000000000100000000000001
        1001000000100000000000001
        1001000000D00000W00000001
111111111011000001110000000000001
1000000000DD00000111D111111111111
1111D111111111011100000010001
11110111111111D11101010010001
110000001101010111000000D0001
10000000000000001100000010001
10000000000000001101010010001
11000001010101011111011110001
1111011101110101 101111010001
1111111111111111 111111111111


!!!!!! a tester avec valgrind .. ne devrais pas se lancer