NO textures/cyber_wall.xpm
SO textures/greencyber_wall.xpm
WE textures/redwood_wall.xpm
EA textures/cyber_wall.xpm
DO textures/cyber_door.xpm

F 0,0,2
C 51,153,5

        1111111111111111111111111
        1000000000100000000000001
        1001000000100000001110001
        1001000000D0000E01 10001
111111111011000001110000001110001
1000000000DD00000111D111111111111
1111D111111111011100000010001
11110111111111D11101010010001
110000001101010111000000D0001
10000000000000001100000010001
10000000000000001101010010001
11000001010101011111011110001
1111011101110101 101111010001
1111111111111111 111111111111